"candles"	["pip fruit",2]
"canned vegetables"	["liver loaf",2]
"frozen chicken"	["herbs",1]
"liquor"	["cream cheese ",2]
"chocolate"	["rolls\/buns",8]
"beverages"	["canned beer",3]
"cat food"	["processed cheese",3]
"herbs"	["yogurt",3]
"packaged fruit\/vegetables"	["rolls\/buns",2]
"turkey"	["long life bakery product",2]
"berries"	["other vegetables",5]
"chicken"	["whole milk",6]
"jam"	["whole milk",1]
"other vegetables"	["soda",16]
"Instant food products"	["whole milk",2]
"finished products"	["whole milk",2]
"snack products"	["whole milk",1]
"white bread"	["whole milk",4]
"whole milk"	["yogurt",16]
"dish cleaner"	["whole milk",2]
"hard cheese"	["coffee",3]
"liqueur"	["onions",1]
"soap"	["chocolate",1]
"artif. sweetener"	["soda",2]
"cling film\/bags"	["soda",2]
"coffee"	["whole milk",5]
"ice cream"	["rolls\/buns",3]
"pastry"	["whole milk",10]
"pot plants"	["soda",2]
"vinegar"	["other vegetables",1]
"cream"	["butter",1]
"decalcifier"	["root vegetables",1]
"frozen potato products"	["root vegetables",2]
"nuts\/prunes"	["whole milk",1]
"liver loaf"	["canned vegetables",2]
"oil"	["other vegetables",3]
"flour"	["curd",1]
"kitchen towels"	["root vegetables",1]
"roll products "	["rolls\/buns",1]
"salad dressing"	["sausage",1]
"white wine"	["frankfurter",3]
"canned beer"	["root vegetables",7]
"dog food"	["sausage",2]
"mayonnaise"	["root vegetables",2]
"processed cheese"	["cat food",3]
"soups"	["root vegetables",2]
"organic products"	["chicken",1]
"pork"	["whole milk",7]
"rice"	["whole milk",2]
"sugar"	["curd",3]
"beef"	["domestic eggs",4]
"bottled beer"	["whole milk",13]
"cocoa drinks"	["photo\/film",1]
"hygiene articles"	["sausage",3]
"instant coffee"	["red\/blush wine",1]
"mustard"	["whipped\/sour cream",2]
"popcorn"	["whipped\/sour cream",1]
"cookware"	["canned beer",1]
"frozen dessert"	["tropical fruit",2]
"frozen vegetables"	["rolls\/buns",6]
"grapes"	["other vegetables",3]
"photo\/film"	["tropical fruit",2]
"pip fruit"	["rolls\/buns",10]
"specialty fat"	["white wine",1]
"zwieback"	["curd cheese",1]
"cereals"	["soda",1]
"ham"	["whole milk",3]
"rolls\/buns"	["tropical fruit",12]
"softener"	["whole milk",2]
"meat spreads"	["butter",1]
"sauces"	["brown bread",1]
"hamburger meat"	["tropical fruit",5]
"napkins"	["margarine",2]
"ready soups"	["flour",1]
"UHT-milk"	["whole milk",5]
"condensed milk"	["tropical fruit",2]
"pickled vegetables"	["whole milk",2]
"canned fruit"	["brown bread",1]
"seasonal products"	["rolls\/buns",2]
"skin care"	["shopping bags",1]
"tea"	["bottled water",1]
"sparkling wine"	["frankfurter",1]
"specialty cheese"	["canned beer",1]
"detergent"	["whole milk",3]
"house keeping products"	["yogurt",2]
"soft cheese"	["yogurt",3]
"pasta"	["sliced cheese",2]
"baking powder"	["curd",2]
"flower soil\/fertilizer"	["curd",1]
"candy"	["whole milk",3]
"nut snack"	["bottled water",1]
"soda"	["other vegetables",16]
"domestic eggs"	["soda",7]
"specialty bar"	["other vegetables",4]
"tropical fruit"	["whole milk",13]
"cream cheese "	["other vegetables",5]
"flower (seeds)"	["rolls\/buns",1]
"onions"	["tropical fruit",6]
"specialty chocolate"	["root vegetables",5]
"butter"	["rolls\/buns",7]
"sausage"	["whole milk",12]
"dental care"	["whole milk",1]
"frozen fish"	["tropical fruit",2]
"tidbits"	["other vegetables",1]
"citrus fruit"	["whole milk",8]
"organic sausage"	["butter milk",1]
"chewing gum"	["pastry",4]
"cleaner"	["pastry",1]
"frankfurter"	["rolls\/buns",10]
"hair spray"	["processed cheese",1]
"root vegetables"	["other vegetables",7]
"specialty vegetables"	["canned fish",1]
"abrasive cleaner"	["meat",1]
"female sanitary products"	["fruit\/vegetable juice",1]
"prosecco"	["sausage",1]
"pudding powder"	["other vegetables",1]
"honey"	["chocolate",1]
"margarine"	["frankfurter",4]
"pet care"	["brown bread",2]
"frozen meals"	["soda",5]
"long life bakery product"	["other vegetables",4]
"salt"	["domestic eggs",2]
"salty snack"	["whole milk",5]
"semi-finished bread"	["whole milk",4]
"waffles"	["rolls\/buns",2]
"curd"	["yogurt",7]
"newspapers"	["whole milk",8]
"rum"	["citrus fruit",1]
"syrup"	["newspapers",2]
"brandy"	["soda",3]
"curd cheese"	["pastry",2]
"fish"	["specialty chocolate",2]
"light bulbs"	["fruit\/vegetable juice",1]
"sliced cheese"	["pork",3]
"cake bar"	["soda",1]
"dessert"	["rolls\/buns",3]
"fruit\/vegetable juice"	["whole milk",5]
"rubbing alcohol"	["citrus fruit",1]
"spread cheese"	["rolls\/buns",3]
"canned fish"	["candy",2]
"ketchup"	["pastry",2]
"liquor (appetizer)"	["hamburger meat",1]
"male cosmetics"	["whole milk",1]
"red\/blush wine"	["instant coffee",1]
"spices"	["soda",1]
"bottled water"	["whole milk",9]
"dishes"	["canned beer",2]
"frozen fruits"	["dishes",1]
"whipped\/sour cream"	["rolls\/buns",6]
"brown bread"	["other vegetables",6]
"yogurt"	["whole milk",16]
"butter milk"	["other vegetables",4]
"misc. beverages"	["sausage",3]
"chocolate marshmallow"	["pastry",1]
"meat"	["pip fruit",2]
"potato products"	["ketchup",1]
"shopping bags"	["whole milk",9]
"sweet spreads"	["butter",2]
